+----------------------+
|           |          |
|  o        |    |     |
|                |     |
|------------    |     |
|                |     |
|    ------------|     |
|         |      |     |
|         |      |     |
|                |     |
|         |      |     |
|         |      |     |
|    --- -|      |     |
|         |      |     |
|         |      |     |
|                |     |
|         |      |     |
|         |      +-----|
|         |            |
|         |          x |
+----------------------+