+---------------------------------------------------------------------------------------------------------------------------------------------------------------------+
|o                                                                                                                                                                |   |
|                                                                                                                                                                 | | |
|                                                                                                                                                                 | | |
|                                                                                                                                                                 | | |
|                                                                                                                                                                 | | |
|                                                                                                                                                                 | | |
|                                                                                                                                                                 | | |
|                                                                                                                                                                 | | |
|                                  ----                                                                                                                           | | |
|                                  |                                                                                                                              | | |
|                                  | | |                                                                                                                          | | |
|                                  | | ---------                                                                                                                  | | |
|                                  | |                                                                                                                            | | |
|--------------------------------------------                                                                                                                     | | |
|                                           |                                                                                                                     | | |
|                                           |                                                                                                                     | | |
|                                           |                                                                                                                     | | |
|                                                                                                                                                                 | | |
|                                                                                                                                                                 | | |
|                                                                                                                                                                 | | |
|                                                                                +---+                                                                            | | |
|                                                                                |   |                                                                            | | |
|                                                                                | | |                                                                            | | |
|                                                                                | | +-----+                                                                      | | |
|                                                                                | |       |                                                                      | | |
|                                                                                | | |     |                                                                      | | |
|                                                                                | | |     |                                                                      | | |
| -------------------------------------------------------------------------------+ + +---- +----------------------------------------------------------------------| | |
|                                                                                  |                                                                              | | |
|---------------------------------------------------------------------------------------------------------------------------------------------------------------- | | |
|                                                                                                                                                                 | | |
| ----------------------------------------------------------------------------------------------------------------------------------------------------------------| | |
|                                                                                                                                                                 | | |
|---------------------------------------------------------------------------------------------------------------------------------------------------------------- | | |
|                                                                                                                                                                 | | |
| ----------------------------------------------------------------------------------------------------------------------------------------------------------------| | |
|                                                                                                                                                                 | | |
|---------------------------------------------------------------------------------------------------------------------------------------------------------------- | | |
|                                                                                                                                                                 | | |
| ----------------------------------------------------------------------------------------------------------------------------------------------------------------| | |
|                                                                                                                                                                 | | |
|---------------------------------------------------------------------------------------------------------------------------------------------------------------- | | |
|                                                                                                                                                                 | | |
| ----------------------------------------------------------------------------------------------------------------------------------------------------------------| | |
|                                                                                                                                                                 | | |
|---------------------------------------------------------------------------------------------------------------------------------------------------------------- | | |
|                                                                                                                                                                 | | |
| ----------------------------------------------------------------------------------------------------------------------------------------------------------------+ | |
|                                                                                                                                                                   |x|
+---------------------------------------------------------------------------------------------------------------------------------------------------------------------+