+---------------------------------------------------------------------------------------------------------------------------------------------------------------------+
|o                                                                                                                                                                |   |
|                                                                                                                                                                 | | |
|                                                                                                                                                                 | | |
|                                                                                                                                                                 | | |
|                                                                                                                                                                 | | |
|                                                                                                                                                                 | | |
|                                                                                                                                                                 | | |
|                                                                                                                                                                 | | |
|                                                                                                                                                                 | | |
|                                                                                                                                                                 | | |
|                                                                                                                                                                 | | |
|                                                                                                                                                                 | | |
|                                                                                                                                                                 | | |
|                                                                                                                                                                 | | |
|                                                                                                                                                                 | | |
|                                                                                                                                                                 | | |
|                                                                                                                                                                 | | |
|                                                                                                                                                                 | | |
|                                                                                                                                                                 | | |
|                                                                                                                                                                 | | |
|                                                                                                                                                                 | | |
|                                                                                                                                                                 | | |
|                                                                                                                                                                 | | |
|                                                                                                                                                                 | | |
|                                                                                                                                                                 | | |
|                                                                                                                                                                 | | |
|                                                                                                                                                                 | | |
|                                                                                                                                                                 | | |
|                                                                                                                                                                 | | |
|                                                                                                                                                                 | | |
|                                                                                                                                                                 | | |
|                                                                                                                                                                 | | |
|                                                                                                                                                                 | | |
|                                                                                                                                                                 | | |
|                                                                                                                                                                 | | |
|                                                                                                                                                                 | | |
|                                                                                                                                                                 | | |
|                                                                                                                                                                 | | |
|                                                                                                                                                                 | | |
|                                                                                                                                                                 | | |
|                                                                                                                                                                 | | |
|                                                                                                                                                                 | | |
|                                                                                                                                                                 | | |
|                                                                                                                                                                 | | |
|                                                                                                                                                                 | | |
|                                                                                                                                                                 | | |
|                                                                                                                                                                 | | |
|                                                                                                                                                                 | | |
|                                                                                                                                                                 | | |
|                                                                                                                                                                 | | |
|---------------------------------------------------------------------------------------------------------------------------------------------------------------- | | |
|                                                                                                                                                                 | | |
| ----------------------------------------------------------------------------------------------------------------------------------------------------------------+ | |
|                                                                                                                                                                   |x|
+---------------------------------------------------------------------------------------------------------------------------------------------------------------------+