+---------------------------------------------------------------------------------------------------------------------------------------------------------------------+
|o                                                                                                                                                                    |
|                                                                                                                                                                     |
|                                                                                                                                                                     |
|                                                                                                                                                                     |
|                                                                                                                                                                     |
|                                                                                                                                                                     |
|                                                                                                                                                                     |
|                                                                                                                                                                     |
|                                                                                                                                                                     |
|                                                                                                                                                                     |
|                                                                                                                                                                     |
|                                                                                                                                                                     |
|                                                                                                                                                                     |
|                                                                                                                                                                     |
|                                                                                                                                                                     |
|                                                                                                                                                                     |
|                                                                                                                                                                     |
|                                                                                                                                                                     |
|                                                                                                                                                                     |
|                                                                                                                                                                     |
|                                                               +------+                                                                                              |
|                                                               |      |                                                                                              |
|                                                               |      |                                                                                              |
|                                                               +------+------+                                                                                       |
|                                                                      |      |                                                                                       |
|                                                                      |      |                                                                                       |
|                                                                      +------+                                                                                       |
|                                                                                                                                                                     |
|                                                                                                                                                                     |
|                                                                                                                                                                     |
|                                                                                                                                                                     |
|                                                                                                                                                                     |
|                                                                                                                                                                     |
|                                                                                                                                                                     |
|                                                                                                                                                                     |
|                                                                                                                                                                     |
|                                                                                                                                                                     |
|                                                                                                                                                                     |
|                                                                                                                                                                     |
|                                                                                                                                                                     |
|                                                                                                                                                                     |
|                                                                                                                                                                     |
|                                                                                                                                                                     |
|                                                                                                                                                                     |
|                                                                                                                                                                     |
|                                                                                                                                                                     |
|                                                                                                                                                                     |
|                                                                                                                                                                     |
|                                                                                                                                                                     |
|                                                                                                                                                                     |
|                                                                                                                                                                     |
|                                                                                                                                                                     |
|                                                                                                                                                                     |
|                                                                                                                                                                     |
|                                                                                                                                                                     |
|                                                                                                                                                                     |
|                                                                                                                                                                     |
|                                                                                                                                                                    x|
+---------------------------------------------------------------------------------------------------------------------------------------------------------------------+