+----------------------+
|           |          |
|  o        |    |     |
|                |     |
|------------    |     |
|                |     |
|    ------------|     |
|                |     |
|                |     |
|         |      |     |
|         |      |     |
|         |      |     |
|    -----|      |     |
|         |      |     |
|         |      |     |
|         |      |     |
|         |      |     |
|         |      +-----|
|         |            |
|         |          x |
+----------------------+